id,blink_type,manual,pupil,difference_n,difference_perc
11002,cprep,9,24,-15,-62.5
11002,cspeech,4,21,-17,-80.95
11002,pprep,20,22,-2,-9.09
11002,pspeech,11,18,-7,-38.89
11004,cprep,29,39,-10,-25.64
11004,cspeech,13,24,-11,-45.83
11004,pprep,33,41,-8,-19.51
11004,pspeech,14,20,-6,-30
11008,cprep,21,30,-9,-30
11008,cspeech,19,22,-3,-13.64
11008,pprep,34,50,-16,-32
11008,pspeech,37,38,-1,-2.63
11010,cprep,33,31,2,6.45
11010,cspeech,12,1,11,1100
11010,pprep,15,7,8,114.29
11010,pspeech,11,5,6,120
